"day_num","date","active_cases","cured","death","total_confirmed_cases"
1,2020-01-30,1,0,0,1
2,2020-02-02,2,0,0,2
3,2020-02-03,3,0,0,3
4,2020-03-02,5,0,0,5
5,2020-03-03,6,0,0,6
6,2020-03-10,47,0,0,47
7,2020-03-11,60,0,0,60
8,2020-03-12,73,0,0,73
9,2020-03-12,71,3,0,74
10,2020-03-13,71,3,1,75
11,2020-03-13,67,10,2,79
12,2020-03-14,71,10,2,83
13,2020-03-14,72,10,2,84
14,2020-03-15,82,9,2,93
15,2020-03-15,96,9,2,107
16,2020-03-15,95,10,2,107
17,2020-03-15,95,13,2,110
18,2020-03-16,99,13,2,114
19,2020-03-17,110,13,2,125
20,2020-03-17,109,13,3,125
21,2020-03-17,110,13,3,126
22,2020-03-17,120,14,3,137
23,2020-03-18,130,14,3,147
24,2020-03-18,134,14,3,151
25,2020-03-19,148,15,3,166
26,2020-03-19,148,15,4,167
27,2020-03-19,149,20,4,173
28,2020-03-20,171,20,4,195
29,2020-03-20,196,23,4,223
30,2020-03-21,231,23,4,258
31,2020-03-21,256,23,4,283
32,2020-03-22,296,24,4,324
33,2020-03-22,295,24,5,324
34,2020-03-22,329,24,7,360
35,2020-03-23,359,24,7,390
36,2020-03-23,359,24,7,390
37,2020-03-23,402,24,7,433
38,2020-03-23,390,35,9,434
39,2020-03-24,446,37,9,492
40,2020-03-24,470,40,9,519
41,2020-03-24,469,40,10,519
42,2020-03-25,512,41,9,562
43,2020-03-25,553,43,10,606
44,2020-03-26,593,43,13,649
45,2020-03-26,634,45,15,694
46,2020-03-27,640,67,17,724
47,2020-03-28,775,79,19,873
48,2020-03-28,810,80,19,909
49,2020-03-29,867,87,25,979
50,2020-03-29,901,96,27,1024
51,2020-03-30,942,100,29,1071
52,2020-03-30,1072,102,31,1205
53,2020-03-31,1200,124,35,1359
54,2020-04-01,1466,133,38,1637
55,2020-04-01,1649,144,41,1834
56,2020-04-02,1764,151,50,1965
57,2020-04-02,1860,156,53,2069
58,2020-04-03,2070,157,56,2283
59,2020-04-03,2245,163,62,2470
60,2020-04-04,2650,184,68,2902
61,2020-04-04,2784,213,75,3072
62,2020-04-05,3030,267,77,3374
63,2020-04-05,3219,275,83,3577
64,2020-04-06,3666,292,109,4067
65,2020-04-06,3851,319,111,4281
66,2020-04-07,3981,326,114,4421
67,2020-04-07,4312,353,124,4789
68,2020-04-08,4643,402,149,5194
69,2020-04-08,4714,411,149,5274
70,2020-04-09,5095,473,166,5734
71,2020-04-09,5218,478,169,5865
72,2020-04-10,5709,504,199,6412
73,2020-04-10,6039,516,206,6761
74,2020-04-11,6565,643,239,7447
75,2020-04-11,6634,653,242,7529
76,2020-04-12,7367,716,273,8356
77,2020-04-12,7409,765,273,8447
78,2020-04-13,7987,857,308,9152
79,2020-04-13,8048,980,324,9352
80,2020-04-14,8988,1036,339,10363
81,2020-04-14,9272,1190,353,10815
82,2020-04-15,9756,1306,377,11439
83,2020-04-15,10197,1344,392,11933
84,2020-04-16,10477,1489,414,12380
85,2020-04-16,10824,1515,420,12759
86,2020-04-17,11201,1749,437,13387
87,2020-04-17,11616,1767,452,13835
88,2020-04-18,11906,1992,480,14378
89,2020-04-18,12289,2015,488,14792
90,2020-04-19,12974,2231,507,15712
91,2020-04-19,13295,2302,519,16116
92,2020-04-20,14175,2547,543,17265
93,2020-04-20,14255,2842,559,17656
94,2020-04-21,14759,3252,590,18601
95,2020-04-21,15122,3260,603,18985
96,2020-04-22,15474,3870,640,19984
97,2020-04-22,15859,3960,652,20471
98,2020-04-23,16454,4258,681,21393
99,2020-04-23,16689,4325,686,21700
100,2020-04-24,17610,4749,718,23077
101,2020-04-24,17915,4814,723,23452
102,2020-04-25,18668,5063,775,24506
103,2020-04-25,18904,5210,779,24893
104,2020-04-26,19868,5804,824,26496
105,2020-04-26,19865,5914,826,26605
106,2020-04-27,20835,6185,872,27892
107,2020-04-27,20912,6362,886,28160
108,2020-04-28,21632,6869,934,29435
109,2020-04-28,21870,7027,937,29834
110,2020-04-29,22629,7696,1007,31332
111,2020-04-29,22904,7797,1008,31709
112,2020-04-30,23651,8325,1074,33050
113,2020-04-30,23882,8373,1075,33330
114,2020-05-01,24716,8889,1147,34752
115,2020-05-01,24755,9065,1152,34972
116,2020-05-02,25988,9951,1218,37157
117,2020-05-02,26430,10018,1223,37671
118,2020-05-03,27922,10633,1301,39856
119,2020-05-03,27931,10887,1306,40124
120,2020-05-04,29453,11707,1373,42533
121,2020-05-04,29685,11762,1389,42836
122,2020-05-05,32138,12727,1568,46433
123,2020-05-05,31967,13161,1583,46711
124,2020-05-06,33514,14183,1694,49391
125,2020-05-07,35902,15267,1783,52952
126,2020-05-08,37916,16540,1886,56342
127,2020-05-09,39834,17847,1981,59662
128,2020-05-10,41472,19358,2109,62939
129,2020-05-11,44029,20917,2206,67152
130,2020-05-12,46008,22455,2293,70756
131,2020-05-13,47480,24386,2415,74281
132,2020-05-14,49219,26235,2549,78003
133,2020-05-15,51401,27920,2649,81970
134,2020-05-16,52805,30153,2752,85710
135,2020-05-17,53656,34109,2872,90637
136,2020-05-18,55906,36824,3029,95759
137,2020-05-19,57988,39174,3163,100325
138,2020-05-20,60053,42298,3303,105654
139,2020-05-21,62221,45300,3435,110956
140,2020-05-22,64710,48534,3583,116827
141,2020-05-23,67698,51784,3720,123202
142,2020-05-24,71222,54441,3867,129530
143,2020-05-25,74461,57721,4021,136203
144,2020-05-26,77752,60491,4167,142410
145,2020-05-27,78991,64426,4337,147754
146,2020-05-28,81778,67692,4531,154001
147,2020-05-29,85314,71106,4706,161126
148,2020-05-30,81379,82370,4971,168720
149,2020-05-31,84504,86984,5164,176652
150,2020-06-01,87692,91819,5394,184905
151,2020-06-02,91167,95527,5598,192292
152,2020-06-03,94374,100303,5815,200492
153,2020-06-04,99254,104107,6075,209436
154,2020-06-05,110960,109462,6348,226770
155,2020-06-06,115942,114073,6642,236657
156,2020-06-07,120406,119293,6929,246628
157,2020-06-08,125381,124095,7135,256611
158,2020-06-09,129917,129215,7466,266598
159,2020-06-10,133632,135206,7745,276583
160,2020-06-11,137448,141029,8102,286579
161,2020-06-12,141842,147195,8498,297535
162,2020-06-13,145779,154330,8884,308993
163,2020-06-14,149348,162379,9195,320922
164,2020-06-15,153106,169798,9520,332424
165,2020-06-16,153178,180013,9900,343091
166,2020-06-17,154638,186935,11903,353476
167,2020-06-18,160384,194325,12237,366946
168,2020-06-19,163248,204711,12573,380532
169,2020-06-20,168269,213831,12948,395048
170,2020-06-21,169451,227756,13254,410461
171,2020-06-22,174387,237196,13699,425282
172,2020-06-23,178014,248190,14011,440215
173,2020-06-24,183022,258685,14476,456183
174,2020-06-25,186514,271697,14894,473105
175,2020-06-26,189463,285637,15301,490401
176,2020-06-27,197387,295881,15685,508953
177,2020-06-28,203051,309713,16095,528859
178,2020-06-29,210120,321723,16475,548318
179,2020-06-30,215125,334822,16893,566840
180,2020-07-01,220114,347979,17400,585493
181,2020-07-02,226947,359860,17834,604641
182,2020-07-03,227439,379892,18213,625544
183,2020-07-04,235433,394227,18655,648315
184,2020-07-05,244814,409083,19268,673165
185,2020-07-06,253287,424433,19693,697413
186,2020-07-07,259557,439948,20160,719665
187,2020-07-08,264944,456831,20642,742417
188,2020-07-09,269789,476378,21129,767296
189,2020-07-10,276685,495513,21604,793802
190,2020-07-11,283407,515386,22123,820916
191,2020-07-12,292258,534621,22674,849553
192,2020-07-13,301609,553471,23174,878254
193,2020-07-14,311565,571460,23727,906752
194,2020-07-15,319840,592032,24309,936181
195,2020-07-16,331146,612815,24915,968876
196,2020-07-17,342473,635757,25602,1003832
197,2020-07-18,358692,653751,26273,1038716
198,2020-07-19,373379,677423,26816,1077618
199,2020-07-20,390459,700087,27497,1118043
200,2020-07-21,402529,724578,28084,1155191
201,2020-07-22,411133,753050,28732,1192915
202,2020-07-23,426167,782607,29861,1238635
203,2020-07-24,440135,817209,30601,1287945
204,2020-07-25,456071,849432,31358,1336861
205,2020-07-26,467882,885577,32063,1385522
206,2020-07-27,485114,917568,32771,1435453
207,2020-07-28,496988,952743,33425,1483156
208,2020-07-29,509447,988029,34193,1531669
209,2020-07-30,528242,1020582,34968,1583792
210,2020-07-31,545318,1057805,35747,1638870
211,2020-08-01,565103,1094374,36511,1695988
212,2020-08-02,567730,1145629,37364,1750723
213,2020-08-03,579357,1186203,38135,1803695
214,2020-08-04,586298,1230509,38938,1855745
215,2020-08-05,586244,1282215,39795,1908254
216,2020-08-06,595501,1328336,40699,1964536
217,2020-08-07,607384,1378105,41585,2027074
218,2020-08-08,619088,1427005,42518,2088611
219,2020-08-09,628747,1480884,43379,2153010
220,2020-08-10,634945,1535743,44386,2215074
221,2020-08-11,639929,1583489,45257,2268675
222,2020-08-12,643948,1639599,46091,2329638
223,2020-08-13,653622,1695982,47033,2396637
224,2020-08-14,661595,1751555,48040,2461190
225,2020-08-15,667950,1808936,49036,2525922
226,2020-08-16,677444,1862258,49980,2589682
227,2020-08-17,676900,1919842,50921,2647663
228,2020-08-18,670066,1977779,51797,2699642
229,2020-08-19,676514,2037870,52889,2767273
230,2020-08-20,686395,2096664,53866,2836925
231,2020-08-21,692030,2158946,54849,2905825
232,2020-08-22,697330,2222577,55794,2975701
233,2020-08-23,707668,2280566,56706,3044940
234,2020-08-24,710771,2338035,57542,3106348
235,2020-08-25,704348,2404585,58390,3167323
236,2020-08-26,707267,2467758,59449,3234474
237,2020-08-27,725991,2523771,60472,3310234
238,2020-08-28,742023,2583948,61529,3387500
239,2020-08-29,752424,2648998,62550,3463972
240,2020-08-30,765302,2713933,63498,3542733
241,2020-08-31,781975,2774801,64469,3621245
242,2020-09-01,785996,2839882,65288,3691166
243,2020-09-02,801282,2901908,66333,3769523
244,2020-09-03,815538,2970492,67376,3853406
245,2020-09-04,831124,3037151,68472,3936747
246,2020-09-05,846395,3107223,69561,4023179
247,2020-09-06,862320,3180865,70626,4113811
248,2020-09-07,882542,3250429,71642,4204613
249,2020-09-08,883697,3323950,72775,4280422
250,2020-09-09,897394,3398844,73890,4370128
251,2020-09-10,919018,3471783,75062,4465863
252,2020-09-11,943480,3542663,76271,4562414
253,2020-09-12,958316,3624196,77472,4659984
254,2020-09-13,973175,3702595,78586,4754356
255,2020-09-14,986598,3780107,79722,4846427
256,2020-09-15,990061,3859399,80776,4930236
257,2020-09-16,995933,3942360,82066,5020359
258,2020-09-17,1009976,4025079,83198,5118253
259,2020-09-18,1017754,4112551,84372,5214677
260,2020-09-19,1013964,4208431,85619,5308014
261,2020-09-20,1010824,4303043,86752,5400619
262,2020-09-21,1003299,4396399,87882,5487580
263,2020-09-22,975861,4497867,88935,5562663
264,2020-09-23,968377,4587613,90020,5646010
265,2020-09-24,966382,4674987,91149,5732518
266,2020-09-25,970116,4756164,92290,5818570
267,2020-09-26,960969,4849584,93379,5903932
268,2020-09-27,956402,4941627,94503,5992532
269,2020-09-28,962640,5016520,95542,6074702
270,2020-09-29,947576,5101397,96318,6145291
271,2020-09-30,940441,5187825,97497,6225763
272,2020-10-01,940705,5273201,98678,6312584
273,2020-10-02,942217,5352078,99773,6394068
274,2020-10-03,944996,5427706,100842,6473544
275,2020-10-04,937625,5509966,101782,6549373
276,2020-10-05,934427,5586703,102685,6623815
277,2020-10-06,919023,5662490,103569,6685082
278,2020-10-07,907883,5744693,104555,6757131
279,2020-10-08,902425,5827704,105526,6835655
280,2020-10-09,893592,5906069,106490,6906151
281,2020-10-10,883185,5988822,107416,6979423
282,2020-10-11,867496,6077976,108334,7053806
283,2020-10-12,861853,6149535,109150,7120538
284,2020-10-13,838729,6227295,109856,7175880
285,2020-10-14,826876,6301927,110586,7239389
286,2020-10-15,812390,6383441,111266,7307097
287,2020-10-16,804528,6453779,112161,7370468
288,2020-10-17,795087,6524595,112998,7432680
289,2020-10-18,783311,6597209,114031,7494551
290,2020-10-19,772055,6663608,114610,7550273
291,2020-10-20,748538,6733328,115197,7597063
292,2020-10-21,740089,6795103,115914,7651106
293,2020-10-22,715812,6874518,116616,7706946
294,2020-10-23,695509,6948497,117306,7761312
295,2020-10-24,680680,7016046,117956,7814682
296,2020-10-25,668154,7078123,118534,7864811
297,2020-10-26,653717,7137228,119014,7909959
298,2020-10-27,625857,7201070,119502,7946429
299,2020-10-28,610803,7259509,120010,7990322
300,2020-10-29,603687,7315989,120527,8040203
301,2020-10-30,594386,7373375,121090,8088851
302,2020-10-31,582649,7432829,121641,8137119
303,2020-11-01,570458,7491513,122111,8184082
304,2020-11-02,561908,7544798,122607,8229313
305,2020-11-03,541405,7603121,123097,8267623
306,2020-11-04,533787,7656478,123611,8313876
307,2020-11-05,527962,7711809,124315,8364086
308,2020-11-06,520773,7765966,124985,8411724
309,2020-11-07,516632,7819886,125562,8462080
310,2020-11-08,512665,7868968,126121,8507754
311,2020-11-09,509673,7917373,126611,8553657
312,2020-11-10,501214,7963457,127059,8591730
313,2020-11-11,494657,8013783,127571,8636011
314,2020-11-12,489294,8066501,128121,8683916
315,2020-11-13,484547,8115580,128668,8728795
316,2020-11-14,480719,8163572,129188,8773479
317,2020-11-15,479216,8205728,129635,8814579
318,2020-11-16,465478,8249579,130070,8845127
319,2020-11-17,453401,8290370,130519,8874290
320,2020-11-18,446805,8335109,130993,8912907
321,2020-11-19,443303,8383602,131578,8958483
322,2020-11-20,443794,8428409,132162,9004365
323,2020-11-21,439747,8478124,132726,9050597
324,2020-11-22,440962,8521617,133227,9095806
325,2020-11-23,443486,8562641,133738,9139865
326,2020-11-24,438667,8604955,134218,9177840
327,2020-11-25,444746,8642771,134699,9222216
328,2020-11-26,452344,8679138,135223,9266705
329,2020-11-27,455555,8718517,135715,9309787
330,2020-11-28,454940,8759969,136200,9351109
331,2020-11-29,453956,8802267,136696,9392919
332,2020-11-30,446952,8847600,137139,9431691
333,2020-12-01,435603,8889585,137621,9462809
334,2020-12-02,428644,8932647,138122,9499413
335,2020-12-03,422943,8973373,138648,9534964
336,2020-12-04,416082,9016289,139188,9571559
337,2020-12-05,409689,9058822,139700,9608211
338,2020-12-06,403248,9100792,140182,9644222
339,2020-12-07,396729,9139901,140573,9677203
340,2020-12-08,383866,9178946,140958,9703770
341,2020-12-09,378909,9215581,141360,9735850
342,2020-12-10,372293,9253306,141772,9767371
343,2020-12-11,363749,9290834,142186,9796769
344,2020-12-12,359819,9324328,142628,9826775
345,2020-12-13,356546,9357464,143019,9857029
346,2020-12-14,352586,9388159,143355,9884100
347,2020-12-15,339820,9422636,143709,9906165
348,2020-12-16,332002,9456449,144096,9932547
349,2020-12-17,322366,9489740,144451,9956557
350,2020-12-18,313831,9520827,144789,9979447
351,2020-12-19,308751,9550712,145136,10004599
352,2020-12-20,305344,9580402,145477,10031223
353,2020-12-21,303639,9606111,145810,10055560
354,2020-12-22,292518,9636487,146111,10075116
355,2020-12-23,289240,9663382,146444,10099066
356,2020-12-24,283849,9693173,146756,10123778
357,2020-12-25,281919,9717834,147092,10146845
358,2020-12-26,281667,9740108,147343,10169118
359,2020-12-27,278690,9761538,147622,10187850
360,2020-12-28,277301,9782669,147901,10207871
361,2020-12-29,268581,9807569,148153,10224303
362,2020-12-30,262272,9834141,148439,10244852
363,2020-12-31,257656,9860280,148738,10266674
364,2021-01-01,254254,9883461,148994,10286709
365,2021-01-02,250183,9906387,149218,10305788
366,2021-01-03,247220,9927310,149435,10323965
367,2021-01-04,243953,9946867,149649,10340469
368,2021-01-05,231036,9975958,149850,10356844
369,2021-01-06,227546,9997272,150114,10374932
370,2021-01-07,228083,10016859,150336,10395278
371,2021-01-08,225449,10037398,150570,10413417
372,2021-01-09,224190,10056651,150798,10431639
373,2021-01-10,223335,10075950,150999,10450284
374,2021-01-11,222526,10092909,151160,10466595
375,2021-01-12,216558,10111294,151327,10479179
376,2021-01-13,214507,10129111,151529,10495147
377,2021-01-14,213603,10146763,151727,10512093
378,2021-01-15,213027,10162738,151918,10527683
379,2021-01-16,211033,10179715,152093,10542841
380,2021-01-17,208826,10196885,152274,10557985
381,2021-01-18,208012,10211342,152419,10571773
382,2021-01-19,200528,10228753,152556,10581837
383,2021-01-20,197201,10245741,152718,10595660
384,2021-01-21,192308,10265706,152869,10610883
385,2021-01-22,188688,10283708,153032,10625428
386,2021-01-23,185662,10300838,153184,10639684
387,2021-01-24,184408,10316786,153339,10654533
388,2021-01-25,184182,10330084,153470,10667736
389,2021-01-26,177266,10345985,153587,10676838
390,2021-01-27,176498,10359305,153724,10689527
391,2021-01-28,173740,10373606,153847,10701193
392,2021-01-29,171686,10394352,154010,10720048
393,2021-01-30,169824,10409160,154147,10733131
394,2021-01-31,168784,10423125,154274,10746183
395,2021-02-01,168235,10434983,154392,10757610
396,2021-02-02,163353,10448406,154486,10766245
397,2021-02-03,160057,10462631,154596,10777284
398,2021-02-04,155025,10480455,154703,10790183
399,2021-02-05,151460,10496308,154823,10802591
400,2021-02-06,148590,10510796,154918,10814304
401,2021-02-07,148766,10522601,154996,10826363
402,2021-02-08,148609,10534505,155080,10838194
403,2021-02-09,143625,10548521,155158,10847304
404,2021-02-10,141511,10561608,155252,10858371
405,2021-02-11,142562,10573372,155360,10871294
406,2021-02-12,135926,10589230,155447,10880603
407,2021-02-13,136571,10600625,155550,10892746
408,2021-02-14,137567,10611731,155642,10904940
409,2021-02-15,139637,10621220,155732,10916589
410,2021-02-16,136872,10633025,155813,10925710
411,2021-02-17,136549,10644858,155913,10937320
412,2021-02-18,137342,10656845,156014,10950201
413,2021-02-19,139542,10667741,156111,10963394
414,2021-02-20,143127,10678048,156212,10977387
415,2021-02-21,145634,10689715,156302,10991651
416,2021-02-22,150055,10699410,156385,11005850
417,2021-02-23,147306,10712665,156463,11016434
418,2021-02-24,146907,10726702,156567,11030176
419,2021-02-25,151708,10738501,156705,11046914
420,2021-02-26,155986,10750680,156825,11063491
421,2021-02-27,159590,10763451,156938,11079979
422,2021-02-28,164511,10775169,157051,11096731
423,2021-03-01,168627,10786457,157157,11112241
424,2021-03-02,168358,10798921,157248,11124527
425,2021-03-03,170126,10812044,157346,11139516
426,2021-03-04,173413,10826075,157435,11156923
427,2021-03-05,176319,10839894,157548,11173761
428,2021-03-06,180304,10854128,157656,11192088
429,2021-03-07,184523,10868520,157756,11210799
430,2021-03-08,188747,10882798,157853,11229398
431,2021-03-09,187462,10899394,157930,11244786
432,2021-03-10,184598,10920046,158063,11262707
433,2021-03-11,189226,10938146,158189,11285561
434,2021-03-12,197237,10953303,158306,11308846
435,2021-03-13,202022,10973260,158446,11333728
436,2021-03-14,210544,10989897,158607,11359048
437,2021-03-15,219262,11007352,158725,11385339
438,2021-03-16,223432,11027543,158856,11409831
439,2021-03-17,234406,11045284,159044,11438734
440,2021-03-18,252364,11063025,159216,11474605
441,2021-03-19,271282,11083679,159370,11514331
442,2021-03-20,288394,11107332,159558,11555284
443,2021-03-21,309087,11130288,159755,11599130
444,2021-03-22,334646,11151468,159967,11646081
445,2021-03-23,345377,11181253,160166,11686796
446,2021-03-24,368457,11205160,160441,11734058
447,2021-03-25,395192,11231650,160692,11787534
448,2021-03-26,421066,11264637,160949,11846652
449,2021-03-27,452647,11295023,161240,11908910
450,2021-03-28,486310,11323762,161552,11971624
451,2021-03-29,521808,11355993,161843,12039644
452,2021-03-30,540720,11393021,162114,12095855
453,2021-03-31,552566,11434301,162468,12149335
454,2021-04-01,584046,11474683,162927,12221656
455,2021-04-02,614696,11525039,163396,12303131
456,2021-04-03,658909,11569241,164110,12392260
457,2021-04-04,691597,11629289,164623,12485509
458,2021-04-05,741830,11682136,165101,12589067
459,2021-04-06,788223,11732279,165547,12686049
460,2021-04-07,843473,11792135,166177,12801785
461,2021-04-08,910319,11851393,166862,12928574
462,2021-04-09,979608,11913292,167642,13060542
463,2021-04-10,1046631,11990859,168436,13205926
464,2021-04-11,1108087,12081443,169275,13358805
465,2021-04-12,1201009,12156529,170179,13527717
466,2021-04-13,1264698,12253697,171058,13689453
467,2021-04-14,1365704,12336036,172085,13873825
468,2021-04-15,1471877,12429564,173123,14074564
469,2021-04-16,1569743,12547866,174308,14291917
470,2021-04-17,1679740,12671220,175649,14526609
471,2021-04-18,1801316,12809643,177150,14788109
472,2021-04-19,1929329,12953821,178769,15061919
473,2021-04-20,2031977,13108582,180530,15321089
474,2021-04-21,2157538,13276039,182553,15616130
475,2021-04-22,2291428,13454880,184657,15930965
476,2021-04-23,2428616,13648159,186920,16263695
477,2021-04-24,2552940,13867997,189544,16610481
478,2021-04-25,2682751,14085110,192311,16960172
479,2021-04-26,2813658,14304382,195123,17313163
480,2021-04-27,2882204,14556209,197894,17636307
481,2021-04-28,2978709,14817371,201187,17997267
482,2021-04-29,3084814,15086878,204832,18376524
483,2021-04-30,3170228,15384418,208330,18762976
484,2021-05-01,3268710,15684406,211853,19164969
485,2021-05-02,3349644,15992271,215542,19557457
486,2021-05-03,3413642,16293003,218959,19925604
487,2021-05-04,3447133,16613292,222408,20282833
488,2021-05-05,3487229,16951731,226188,20665148
489,2021-05-06,3566398,17280844,230168,21077410
490,2021-05-07,3645164,17612351,234083,21491598
491,2021-05-08,3723446,17930960,238270,21892676
492,2021-05-09,3736648,18317404,242362,22296414
493,2021-05-10,3745237,18671222,246116,22662575
494,2021-05-11,3715221,19027304,249992,22992517
495,2021-05-12,3704099,19382642,254197,23340938
496,2021-05-13,3710525,19734823,258317,23703665
497,2021-05-14,3704893,20079599,262317,24046809
498,2021-05-15,3673802,20432898,266207,24372907
499,2021-05-16,3618458,20795335,270284,24684077
500,2021-05-17,3516997,21174076,274390,24965463
501,2021-05-18,3353765,21596512,278719,25228996
502,2021-05-19,3226719,21986363,283248,25496330
503,2021-05-20,3129878,22355440,287122,25772440
504,2021-05-21,3027925,22712735,291331,26031991
505,2021-05-22,2923400,23070365,295525,26289290
506,2021-05-23,2805399,23425467,299266,26530132
507,2021-05-24,2720716,23728011,303720,26752447
508,2021-05-25,2586782,24054861,307231,26948874
509,2021-05-26,2495591,24350816,311388,27157795
510,2021-05-27,2419907,24633951,315235,27369093
511,2021-05-28,2343152,24893410,318895,27555457
512,2021-05-29,2228724,25178011,322512,27729247
513,2021-05-30,2114508,25454320,325972,27894800
514,2021-05-31,2026092,25692342,329100,28047534
515,2021-06-01,1895520,25947629,331895,28175044
516,2021-06-02,1793645,26179085,335102,28307832
517,2021-06-03,1713413,26390584,337989,28441986
518,2021-06-04,1635993,26597655,340702,28574350
519,2021-06-05,1555248,26795549,344082,28694879
520,2021-06-06,1477799,26984781,346759,28809339
521,2021-06-07,1401609,27159180,349186,28909975
522,2021-06-08,1303702,27341462,351309,28996473
523,2021-06-09,1231415,27504126,353528,29089069
524,2021-06-10,1167952,27655493,359676,29183121
525,2021-06-11,1121671,27790073,363079,29274823
526,2021-06-12,1080690,27911384,367081,29359155
527,2021-06-13,1026159,28043446,370384,29439989
528,2021-06-14,973158,28162947,374305,29510410
529,2021-06-15,913378,28280472,377031,29570881
530,2021-06-16,865432,28388100,379573,29633105
531,2021-06-17,826740,28491670,381903,29700313
532,2021-06-18,798656,28580647,383490,29762793
533,2021-06-19,760019,28678390,385137,29823546
534,2021-06-20,729243,28766009,386713,29881965
535,2021-06-21,702887,28844199,388135,29935221
536,2021-06-22,662521,28926038,389302,29977861
537,2021-06-23,643194,28994855,390660,30028709
538,2021-06-24,627057,29063740,391981,30082778
539,2021-06-25,612868,29128267,393310,30134445
540,2021-06-26,595565,29193085,394493,30183143
541,2021-06-27,586403,29251029,395751,30233183
542,2021-06-28,572994,29309607,396730,30279331
543,2021-06-29,552659,29366601,397637,30316897
544,2021-06-30,537064,29427330,398454,30362848
545,2021-07-01,523257,29488918,399459,30411634
546,2021-07-02,509637,29548302,400312,30458251
547,2021-07-03,495533,29605779,401050,30502362
548,2021-07-04,485350,29658078,402005,30545433
549,2021-07-05,482071,29700430,402728,30585229
550,2021-07-06,464357,29752294,403281,30619932
551,2021-07-07,459920,29799534,404211,30663665
552,2021-07-08,460704,29843825,405028,30709557
553,2021-07-09,458727,29888284,405939,30752950
554,2021-07-10,455033,29933538,407145,30795716
555,2021-07-11,454118,29975064,408040,30837222
556,2021-07-12,450899,30014713,408764,30874376
557,2021-07-13,431315,30063720,410784,30905819
558,2021-07-14,429946,30104720,411408,30946074
559,2021-07-15,432041,30143850,411989,30987880
560,2021-07-16,430422,30183876,412531,31026829
561,2021-07-17,424025,30227792,413091,31064908
562,2021-07-18,422660,30269796,413609,31106065
563,2021-07-19,421665,30308456,414108,31144229
564,2021-07-20,406130,30353710,414482,31174322
565,2021-07-21,421665,30308456,414108,31144229
566,2021-07-22,409394,30429339,418987,31257720
567,2021-07-23,405513,30468079,419470,31293062
568,2021-07-24,408977,30503166,420016,31332159
569,2021-07-25,408212,30543138,420551,31371901
570,2021-07-26,411189,30579106,420967,31411262
571,2021-07-27,398100,30621469,421382,31440951
572,2021-07-28,399436,30663147,422022,31484605
573,2021-07-29,403840,30701612,422662,31528114
574,2021-07-30,405155,30743972,423217,31572344
575,2021-07-31,408920,30781263,423810,31613993
576,2021-08-01,410952,30820521,424351,31655824
577,2021-08-02,413718,30857467,424773,31695958
578,2021-08-03,404958,30896354,425195,31726507
579,2021-08-04,410353,30933022,425757,31769132
580,2021-08-05,411076,30974748,426290,31812114
581,2021-08-06,414159,31015844,426754,31856757
582,2021-08-07,412153,31055861,427371,31895385
583,2021-08-08,406822,31099771,427862,31934455
584,2021-08-09,402188,31139457,428309,31969954
585,2021-08-10,388508,31180968,428682,31998158
586,2021-08-11,386351,31220981,429179,32036511
587,2021-08-12,387987,31260050,429669,32077706
588,2021-08-13,385227,31302345,430254,32117826
589,2021-08-14,387673,31338088,430732,32156493
590,2021-08-15,385336,31376015,431225,32192576
591,2021-08-16,381947,31411924,431642,32225513
592,2021-08-17,369846,31448754,432079,32250679
593,2021-08-18,367415,31485923,432519,32285857
594,2021-08-19,364129,31525080,433049,32322258
595,2021-08-20,363605,31561635,433589,32358829
596,2021-08-21,361340,31597982,433964,32393286
597,2021-08-22,353398,31636469,434367,32424234
598,2021-08-23,333924,31680626,434756,32449306
599,2021-08-24,319551,31720112,435110,32474773
600,2021-08-25,322327,31754281,435758,32512366
601,2021-08-26,333725,31788440,436365,32558530
602,2021-08-27,344899,31821428,436861,32603188
603,2021-08-28,359775,31852802,437370,32649947
604,2021-08-29,368558,31888642,437830,32695030
605,2021-08-30,376324,31923405,438210,32737939
606,2021-08-31,370640,31959680,438560,32768880
607,2021-09-01,378181,31993644,439020,32810845
608,2021-09-02,389583,32028825,439529,32857937
609,2021-09-03,399778,32063616,439895,32903289
610,2021-09-04,405681,32100001,440225,32945907
611,2021-09-05,410048,32138092,440533,32988673
612,2021-09-06,404874,32181995,440752,33027621
613,2021-09-07,392864,32224937,441042,33058843
614,2021-09-08,391256,32264051,441411,33096718
615,2021-09-09,393614,32304618,441749,33139981
616,2021-09-10,390646,32342299,442009,33174954
617,2021-09-11,391516,32374497,442317,33208330
618,2021-09-12,384921,32409345,442655,33236921
619,2021-09-13,374269,32447032,442874,33264175
620,2021-09-14,362207,32484159,443213,33289579
621,2021-09-15,351087,32522171,443497,33316755
622,2021-09-16,390646,32342299,442009,33174954
623,2021-09-17,339056,32598424,444248,33381728
624,2021-09-18,340639,32632222,444529,33417390
625,2021-09-19,332158,32671167,444838,33448163
626,2021-09-20,318181,32715105,445133,33478419
627,2021-09-21,309575,32749574,445385,33504534
628,2021-09-22,301989,32783741,445768,33531498
629,2021-09-24,300162,32848273,446368,33594803
630,2021-09-25,301442,32876319,446658,33624419
631,2021-09-26,303476,32902351,446918,33652745
632,2021-09-27,299620,32931972,447194,33678786
633,2021-09-28,292206,32958002,447373,33697581
634,2021-09-29,282520,32986180,447751,33716451
635,2021-09-30,277020,33014898,448062,33739980
636,2021-10-01,275224,33043144,448339,33766707
637,2021-10-02,273889,33068599,448573,33791061
638,2021-10-03,270557,33094529,448817,33813903
639,2021-10-04,264458,33121247,448997,33834702
640,2021-10-05,252902,33150886,449260,33853048
641,2021-10-06,246687,33175656,449538,33871881
642,2021-10-07,244198,33200258,449856,33894312
643,2021-10-08,240221,33225221,450127,33915569
644,2021-10-09,236643,33248291,450375,33935309
645,2021-10-10,230971,33271915,450589,33953475
646,2021-10-11,227347,33293478,450782,33971607
647,2021-10-12,214900,33320057,450963,33985920
648,2021-10-13,207653,33342901,451189,34001743
649,2021-10-14,206586,33362709,451435,34020730
650,2021-10-15,203678,33382100,451814,34037592
651,2021-10-16,201632,33399961,451980,34053573
652,2021-10-17,195846,33419749,452124,34067719
653,2021-10-18,189694,33439331,452290,34081315
654,2021-10-19,183118,33458801,452454,34094373
655,2021-10-20,178098,33478247,452651,34108996
656,2021-10-21,178831,33495808,452811,34127450
657,2021-10-22,175745,33514449,453042,34143236
658,2021-10-23,173728,33532126,453708,34159562
659,2021-10-24,172594,33548605,454269,34175468
660,2021-10-25,167695,33567367,454712,34189774
661,2021-10-26,163816,33583318,455068,34202202
662,2021-10-27,162661,33597339,455653,34215653
663,2021-10-28,160989,33614434,456386,34231809
664,2021-10-29,161334,33627632,457191,34246157
665,2021-10-30,161555,33641175,457740,34260470
666,2021-10-31,159272,33655842,458186,34273300
667,2021-11-01,158817,33668560,458437,34285814
668,2021-11-02,153776,33683581,458880,34296237
669,2021-11-03,151209,33697740,459191,34308140
670,2021-11-04,148579,33712794,459652,34321025
671,2021-11-05,148922,33724959,459873,34333754
672,2021-11-06,146950,33737468,460265,34344683
673,2021-11-07,144845,33749900,460791,34355536
674,2021-11-08,142826,33763104,461057,34366987
675,2021-11-09,140638,33775086,461389,34377113
676,2021-11-10,139683,33787047,461849,34388579
677,2021-11-11,138556,33800925,462189,34401670
678,2021-11-12,137416,33814080,462690,34414186
679,2021-11-13,136308,33826483,463245,34426036
680,2021-11-14,135918,33837859,463530,34437307
681,2021-11-15,134096,33849785,463655,34447536
682,2021-11-16,130793,33861756,463852,34456401
683,2021-11-17,128555,33873890,464153,34466598
684,2021-11-18,128762,33885132,464623,34478517
685,2021-11-19,126620,33897921,465082,34489623
686,2021-11-20,124868,33909708,465349,34499925
687,2021-11-21,122714,33922037,465662,34510413
688,2021-11-22,118440,33934547,465911,34518898
689,2021-11-23,113584,33946749,466147,34526480
690,2021-11-24,111481,33957698,466584,34535763
691,2021-11-25,109940,33967962,466980,34544882
692,2021-11-26,110133,33977830,467468,34555431
693,2021-11-27,107019,33988797,467933,34563749
694,2021-11-28,105691,33998278,468554,34572523
695,2021-11-29,103859,34008183,468790,34580832
696,2021-11-30,100543,34018299,468980,34587822
697,2021-12-01,99022,34028506,469247,34596775
698,2021-12-02,99763,34037054,469724,34606541
699,2021-12-03,99976,34045666,470115,34615757
700,2021-12-04,99974,34053856,470530,34624360
701,2021-12-05,99155,34060774,473326,34633255
702,2021-12-06,98416,34069608,473537,34641561
703,2021-12-07,95014,34079612,473757,34648383
704,2021-12-08,93733,34089137,473952,34656822
705,2021-12-09,94742,34097388,474111,34666241
706,2021-12-10,94943,34105066,474735,34674744
707,2021-12-11,93277,34114331,475128,34682736
708,2021-12-12,92281,34122795,475434,34690510
709,2021-12-13,91456,34130768,475636,34697860
710,2021-12-14,88993,34138763,475888,34703644
711,2021-12-15,87562,34146931,476135,34710628
712,2021-12-16,87245,34154879,476478,34718602
713,2021-12-17,86415,34162765,476869,34726049
714,2021-12-18,84565,34171471,477158,34733194
715,2021-12-19,83913,34178940,477422,34740275
716,2021-12-20,82267,34187017,477554,34746838
717,2021-12-21,79097,34195060,478007,34752164
718,2021-12-22,78190,34201966,478325,34758481
719,2021-12-23,78291,34208926,478759,34765976
720,2021-12-24,77516,34215977,479133,34772626
721,2021-12-25,77032,34223263,479520,34779815
722,2021-12-26,76766,34230354,479682,34786802
723,2021-12-27,75841,34237495,479997,34793333
724,2021-12-28,75456,34243945,480290,34799691
725,2021-12-29,77002,34251292,480592,34808886
726,2021-12-30,82402,34258778,480860,34822040
727,2021-12-31,91361,34266363,481080,34838804
728,2022-01-01,104781,34275312,481486,34861579
729,2022-01-02,122801,34284561,481770,34889132
730,2022-01-03,145582,34295407,481893,34922882
731,2022-01-04,171830,34306414,482017,34960261
732,2022-01-05,214004,34321803,482551,35018358
733,2022-01-06,285401,34341009,482876,35109286
734,2022-01-07,371363,34371845,483178,35226386
735,2022-01-08,472169,34412740,483463,35368372
736,2022-01-09,590611,34453603,483790,35528004
737,2022-01-10,723619,34500172,483936,35707727
738,2022-01-11,821446,34570131,484213,35875790
739,2022-01-12,-644404,36230536,484378,36070510
740,2022-01-13,1117531,34715361,485035,36317927
741,2022-01-14,1272073,34824706,485350,36582129
742,2022-01-15,1417820,34947390,485752,36850962
743,2022-01-16,1550377,35085721,486066,37122164
744,2022-01-17,1656341,35237461,486451,37380253
745,2022-01-18,1736628,35394882,486761,37618271
746,2022-01-19,1831000,35583039,487202,37901241
747,2022-01-20,1924051,35807029,487693,38218773
748,2022-01-21,2018825,36058806,488396,38566027
749,2022-01-22,2113365,36301482,488884,38903731
750,2022-01-23,2187205,36560650,489409,39237264
751,2022-01-24,2249335,36804145,489848,39543328
752,2022-01-25,2236842,37071898,490462,39799202
753,2022-01-26,2223018,37370971,491127,40085116
754,2022-01-27,2202472,37677328,491700,40371500
755,2022-01-28,2105611,38024771,492327,40622709
756,2022-01-29,2004333,38360710,493198,40858241
757,2022-01-30,1884937,38713494,494091,41092522
758,2022-01-31,1831268,38976122,495050,41302440
759,2022-02-01,1743059,39230198,496242,41469499
760,2022-02-02,1621603,39511307,497975,41630885
761,2022-02-03,1533921,39770414,498983,41803318
762,2022-02-04,1435569,40017088,500055,41952712
763,2022-02-05,1331648,40247902,501114,42080664
764,2022-02-06,1225011,40461148,501979,42188138
765,2022-02-07,1108938,40660202,502874,42272014
766,2022-02-08,994891,40840658,504062,42339611
767,2022-02-09,892828,41012869,505279,42410976
768,2022-02-10,790789,41180751,506520,42478060
769,2022-02-11,697802,41331158,507177,42536137
770,2022-02-12,610443,41468120,507981,42586544
771,2022-02-13,537045,41585711,508665,42631421
772,2022-02-14,478882,41677641,509011,42665534
773,2022-02-15,423127,41760458,509358,42692943
774,2022-02-16,370240,41843446,509872,42723558
775,2022-02-17,332918,41910984,510413,42754315
776,2022-02-18,292092,41977238,510905,42780235
777,2022-02-19,253739,42037536,511230,42802505
778,2022-02-20,224187,42086383,511903,42822473
779,2022-02-21,202131,42124284,512109,42838524
780,2022-02-22,181075,42158510,512344,42851929
781,2022-02-23,164522,42189887,512622,42867031
782,2022-02-24,148359,42219896,512924,42881179
783,2022-02-25,134235,42246884,513226,42894345
784,2022-02-26,121881,42270482,513481,42905844
785,2022-02-27,111472,42290921,513724,42916117
786,2022-02-28,102601,42307686,513843,42924130
787,2022-03-01,92472,42324550,514023,42931045
788,2022-03-02,85680,42338673,514246,42938599
789,2022-03-03,77152,42353620,514388,42945160
790,2022-03-04,69897,42367070,514589,42951556
791,2022-03-05,63878,42378721,514878,42957477
792,2022-03-06,59442,42388475,515036,42962953
793,2022-03-07,54118,42398095,515102,42967315
794,2022-03-08,49948,42406150,515210,42971308
